 ########################################
 # ..................................##.#
 #.#########.###########.###########..#.#
 #....................................#.#
 ##.########.###########.###########....#
 #.........#.............#............#.#
 #.#######.#.#########.#...#########..#.#
 #.......#.#.#.........#...#..#..#......#
 #.........#.....#.....#...#........#####
 #.######........#............##....#...#
 #...........#####.....#...#..##........#
 ########################################